przedsiębiorca;426;293;133;576904;1354.23
nauczyciel;406;161;245;525564;1294.49
ekonomista;311;167;144;511135;1643.52
rolnik;152;106;46;172945;1137.80
prawnik;131;73;58;342627;2615.47
pracownik biurowy;117;39;78;60985;521.24
politolog;114;75;39;277256;2432.07
emeryt;85;57;28;46066;541.95
wyższy urzędnik samorządowy;80;42;38;190082;2376.03
nauczyciel akademicki;68;47;21;155120;2281.18
pedagog;67;19;48;99277;1481.75
informatyk;57;52;5;86749;1521.91
lekarz;56;38;18;113703;2030.41
urzędnik samorządowy;56;30;26;108861;1943.95
student;55;43;12;40883;743.33
pielęgniarka;52;0;52;42250;812.50
pracownik samorządowy;48;27;21;87402;1820.88
radca prawny;48;31;17;102125;2127.60
księgowa;46;0;46;52031;1131.11
urzędnik;43;26;17;61004;1418.70
socjolog;42;16;26;100926;2403.00
przedstawiciel władzy samorządowej;41;32;9;138302;3373.22
dziennikarz;41;21;20;92598;2258.49
adwokat;37;26;11;106481;2877.86
sprzedawca;36;6;30;15946;442.94
psycholog;35;7;28;46630;1332.29
historyk;34;28;6;95731;2815.62
nauczycielka;33;0;33;47653;1444.03
prezes;32;24;8;44706;1397.06
technik ekonomista;31;6;25;15981;515.52
ekonomistka;30;0;30;91207;3040.23
handlowiec;29;19;10;16760;577.93
specjalista administracji publicznej;29;7;22;29034;1001.17
inżynier mechanik;28;26;2;40590;1449.64
menedżer;27;19;8;65991;2444.11
emerytka;27;0;27;13551;501.89
przedstawiciel handlowy;27;15;12;17291;640.41
inżynier budownictwa;25;23;2;40036;1601.44
fizjoterapeuta;24;7;17;16969;707.04
samorządowiec;24;16;8;63193;2633.04
nauczyciel przedmiotu w szkole ponadpodstawowej;24;13;11;27800;1158.33
pracownik socjalny;23;3;20;14455;628.48
administratywista;23;12;11;27666;1202.87
architekt;23;8;15;31478;1368.61
kierowca;23;22;1;7291;317.00
inżynier elektryk;23;23;0;18099;786.91
parlamentarzysta;22;15;7;183238;8329.00
lekarz medycyny;21;15;6;83309;3967.10
manager;21;16;5;21967;1046.05
inżynier rolnictwa;20;13;7;35869;1793.45
kierownik projektu;20;13;7;41437;2071.85
dyrektor szkoły;20;8;12;49959;2497.95
urzędnik państwowy;20;12;8;58970;2948.50
technik mechanik;18;18;0;9008;500.44
programista aplikacji;17;17;0;10933;643.12
programista;16;12;4;18972;1185.75
nauczyciel przedmiotu w szkole podstawowej;16;8;8;18279;1142.44
technik informatyk;16;14;2;11515;719.69
geodeta;15;12;3;31377;2091.80
lekarz weterynarii;14;7;7;21453;1532.36
księgowy;14;8;6;9365;668.93
studentka;14;0;14;13372;955.14
nauczyciel akademicki - nauki humanistyczne;14;5;9;38033;2716.64
zarządca nieruchomości;14;5;9;12265;876.07
pracownik administracyjny;13;4;9;7448;572.92
magazynier;13;8;5;3049;234.54
kierownik biura;13;6;7;13616;1047.38
agent ubezpieczeniowy;13;7;6;6678;513.69
dyrektor generalny;13;10;3;27400;2107.69
elektryk;12;10;2;3996;333.00
dyrektor handlowy;11;7;4;18737;1703.36
chemik;11;5;6;14081;1280.09
doradca klienta;11;5;6;9611;873.73
logistyk;11;7;4;14375;1306.82
leśnik;11;10;1;21393;1944.82
nauczyciel akademicki - nauki społeczne;11;7;4;14874;1352.18
nauczyciel edukacji wczesnoszkolnej;11;0;11;7600;690.91
ogrodnik;11;7;4;7284;662.18
technik elektryk;11;11;0;4851;441.00
specjalista do spraw sprzedaży;10;5;5;9110;911.00
kucharz;10;3;7;3680;368.00
kosmetolog;10;0;10;4223;422.30
menadżer;10;9;1;27176;2717.60
inżynier inżynierii środowiska;10;7;3;9405;940.50
fizyk;10;7;3;11363;1136.30
grafik komputerowy;10;4;6;10338;1033.80
fotograf;9;6;3;8904;989.33
elektronik;9;9;0;3432;381.33
menedżer produktu;9;6;3;5165;573.89
krawcowa;9;0;9;2725;302.78
technik handlowiec;9;5;4;3192;354.67
technik ogrodnik;9;5;4;3350;372.22
technik budowlany;9;6;3;2714;301.56
trener sportu;9;7;2;4032;448.00
nauczyciel historii;9;8;1;11290;1254.44
pedagog specjalny;9;2;7;14493;1610.33
opiekun medyczny;9;1;8;5349;594.33
położna;8;0;8;18106;2263.25
pracownik administracji;8;3;5;3729;466.13
technik budownictwa;8;5;3;3074;384.25
technik administracji;8;4;4;3394;424.25
technik rolnik;8;3;5;5492;686.50
kulturoznawca;8;3;5;15447;1930.88
kosmetyczka;8;0;8;3299;412.38
menager;8;6;2;21572;2696.50
muzyk;8;5;3;3545;443.13
kierowca zawodowy;8;7;1;2376;297.00
elektromechanik;8;7;1;2912;364.00
fryzjer;8;2;6;3468;433.50
farmaceuta;8;3;5;22968;2871.00
inżynier budownictwa - budownictwo ogólne;8;5;3;4166;520.75
bibliotekarz;8;1;7;17660;2207.50
biolog;8;4;4;13764;1720.50
biotechnolog;8;2;6;7312;914.00
animator kultury;8;1;7;8561;1070.13
cukiernik;7;1;6;1203;171.86
dyrektor finansowy;7;5;2;12697;1813.86
inżynier;7;7;0;14400;2057.14
górnik;7;7;0;2702;386.00
geolog;7;4;3;10099;1442.71
historyk sztuki;7;2;5;12991;1855.86
filolog języka nowożytnego;7;3;4;15006;2143.71
filolog polski;7;3;4;19971;2853.00
inżynier środowiska;7;2;5;6441;920.14
inżynier zootechniki;7;5;2;10335;1476.43
mechanik samochodowy;7;7;0;2222;317.43
mechanik;7;7;0;2977;425.29
specjalista do spraw stosunków międzynarodowych;7;6;1;7839;1119.86
specjalista ochrony środowiska;7;3;4;4238;605.43
pośrednik w obrocie nieruchomościami;7;2;5;8969;1281.29
nauczyciel przedszkola;7;0;7;4046;578.00
zarządzający przedsiębiorstwem;7;4;3;3597;513.86
wykładowca akademicki;7;3;4;8175;1167.86
wyższy urzędnik państwowy;6;4;2;21187;3531.17
zootechnik;6;5;1;7931;1321.83
organizator imprez rozrywkowych;6;5;1;1034;172.33
pracownik ochrony fizycznej;6;4;2;2623;437.17
pracownik obsługi biurowej;6;2;4;3568;594.67
ratownik medyczny;6;5;1;8281;1380.17
rencista;6;5;1;1984;330.67
specjalista ds. sprzedaży;6;3;3;5011;835.17
spedytor;6;5;1;4839;806.50
stolarz;6;5;1;3193;532.17
specjalista do spraw public relations;6;2;4;10579;1763.17
technik hotelarstwa;6;1;5;4114;685.67
tłumacz;6;1;5;7361;1226.83
kierownik do spraw sprzedaży;6;3;3;2752;458.67
dziennikarka;6;0;6;43966;7327.67
administrator nieruchomości;6;5;1;1515;252.50
archeolog;5;3;2;1233;246.60
asystent prawny;5;1;4;5634;1126.80
dyrektor do spraw administracyjnych;5;3;2;3744;748.80
doradca podatkowy;5;3;2;3772;754.40
dietetyk;5;1;4;1760;352.00
główny księgowy;5;1;4;4151;830.20
górnik eksploatacji podziemnej;5;5;0;1800;360.00
inżynier elektroenergetyk;5;5;0;3725;745.00
inżynier elektronik;5;5;0;9936;1987.20
dyrektor zarządzający;5;3;2;2709;541.80
kierowca samochodu ciężarowego;5;5;0;1856;371.20
kierownik/właściciel zakładu usługowego;5;3;2;7653;1530.60
kontroler finansowy;5;5;0;4714;942.80
inżynier technologii żywności;5;3;2;4645;929.00
krawiec;5;0;5;2815;563.00
technik elektronik;5;5;0;3836;767.20
specjalista do spraw zarządzania;5;3;2;21840;4368.00
specjalista do spraw kadr;5;0;5;2408;481.60
starosta;5;5;0;17647;3529.40
przedsiębiorczyni;5;0;5;9673;1934.60
pracownik administracji publicznej;5;1;4;6192;1238.40
pracownik administracji samorządowej;5;2;3;7942;1588.40
nauczyciel języka obcego;5;1;4;6063;1212.60
muzealnik;4;3;1;4863;1215.75
oficer sił zbrojnych;4;4;0;2747;686.75
opiekunka dziecięca;4;0;4;2754;688.50
poseł na Sejm RP;4;3;1;31702;7925.50
publicysta;4;4;0;16480;4120.00
strażak;4;4;0;4897;1224.25
specjalista kontroli jakości;4;2;2;2108;527.00
specjalista zastosowań informatyki;4;4;0;2877;719.25
specjalista ds. pozyskiwania funduszy;4;0;4;3038;759.50
specjalista ds. public relations;4;4;0;5180;1295.00
specjalista ds. logistyki;4;2;2;2101;525.25
specjalista do spraw administracji i zarządzania;4;1;3;4036;1009.00
technik dentystyczny;4;1;3;11663;2915.75
technik architektury krajobrazu;4;1;3;690;172.50
technik logistyk;4;3;1;2005;501.25
trener osobisty;4;2;2;12663;3165.75
właściciel zakładu usługowego;4;4;0;1878;469.50
technik technologii żywności;4;4;0;8412;2103.00
technik żywienia i usług gastronomicznych;4;1;3;1221;305.25
technik urządzeń sanitarnych;4;4;0;1035;258.75
technik weterynarii;4;1;3;3316;829.00
technik żywienia;4;0;4;952;238.00
lekarz dentysta;4;2;2;3269;817.25
listonosz;4;4;0;1954;488.50
mechanik pojazdów samochodowych;4;4;0;602;150.50
inżynier teleinformatyk;4;3;1;2598;649.50
inżynier rolnik;4;3;1;15920;3980.00
inżynier ochrony środowiska;4;3;1;2924;731.00
inżynier leśnictwa;4;3;1;13553;3388.25
kierownik sklepu;4;0;4;2117;529.25
kierownik pociągu;4;3;1;2129;532.25
kierownik działu administracyjno-gospodarczego;4;3;1;2167;541.75
kierownik obiektu sportowego;4;4;0;3468;867.00
inż. budownictwa;4;3;1;1055;263.75
grafik;4;2;2;2014;503.50
doradca finansowy;4;2;2;2843;710.75
biegły rewident;4;3;1;6123;1530.75
bez zawodu;4;0;4;2053;513.25
dyrektor;4;2;2;9206;2301.50
dyrektor marketingu;4;2;2;3983;995.75
architekt krajobrazu;4;2;2;1909;477.25
asystent osoby niepełnosprawnej;4;0;4;3559;889.75
aktor;4;2;2;7529;1882.25
analityk;4;1;3;1771;442.75
zawodowy działacz organizacji pozarządowej;4;4;0;3987;996.75
zawodowy działacz organizacji związkowej;4;3;1;2300;575.00
zawodowy działacz organizacji pozarządowych;3;0;3;8218;2739.33
wydawca;3;3;0;19832;6610.67
właściciel małego sklepu;3;2;1;1797;599.00
analityk biznesowy;3;0;3;3230;1076.67
analityk finansowy;3;2;1;14193;4731.00
analityk systemów teleinformatycznych;3;1;2;2346;782.00
aktorka;3;0;3;13338;4446.00
architekt wnętrz;3;1;2;1899;633.00
automatyk;3;3;0;1036;345.33
dyrektor operacyjny;3;1;2;7991;2663.67
budowlaniec;3;3;0;1503;501.00
blacharz samochodowy;3;3;0;640;213.33
instruktor nauki jazdy;3;3;0;1527;509.00
instruktor sportu;3;1;2;6098;2032.67
inżynier architekt;3;1;2;1957;652.33
inżynier automatyki i robotyki;3;3;0;15662;5220.67
inżynier budowy dróg;3;3;0;2831;943.67
dyrektor techniczny;3;3;0;1063;354.33
dyrektor rozwoju biznesu;3;2;1;4442;1480.67
elektromonter;3;3;0;2134;711.33
dyrektor sprzedaży;3;2;1;989;329.67
filozof;3;2;1;2720;906.67
inżynier technologii chemicznej;3;1;2;2402;800.67
kierownik domu kultury;3;2;1;2885;961.67
konstruktor;3;3;0;2766;922.00
inżynier energetyk;3;1;2;1661;553.67
inżynier górnik;3;2;1;24399;8133.00
inżynier pożarnictwa;3;3;0;10118;3372.67
inżynier sanitarny;3;3;0;4301;1433.67
inżynier mechatronik;3;3;0;2032;677.33
inżynier transportu;3;3;0;783;261.00
lektor języka obcego;3;0;3;5799;1933.00
lekarz stomatolog;3;2;1;5061;1687.00
magister administracji;3;1;2;1724;574.67
technolog żywności;3;1;2;1125;375.00
teolog;3;1;2;2022;674.00
terapeuta zajęciowy;3;0;3;1162;387.33
technik telekomunikacji;3;3;0;5270;1756.67
technik technologii odzieży;3;0;3;1399;466.33
technik energetyk;3;3;0;1937;645.67
technik samochodowy;3;3;0;262;87.33
specjalista do spraw pozyskiwania funduszy;3;0;3;4702;1567.33
specjalista do spraw logistyki;3;2;1;988;329.33
specjalista do spraw marketingu;3;3;0;2737;912.33
specjalista do spraw marketingu i handlu;3;1;2;7022;2340.67
specjalista bankowości;3;1;2;12663;4221.00
spawacz;3;3;0;414;138.00
sekretarka;3;0;3;2121;707.00
specjalista do spraw rachunkowości;3;0;3;8862;2954.00
specjalista ds. stosunków międzynarodowych;3;2;1;4343;1447.67
specjalista ds. zamówień publicznych;3;0;3;2996;998.67
specjalista ds. zarządzania;3;2;1;6315;2105.00
redaktor serwisu internetowego;3;3;0;4520;1506.67
rejestratorka medyczna;3;0;3;998;332.67
psychoterapeuta;3;0;3;3691;1230.33
pracownik administracyjno-biurowy;3;2;1;2206;735.33
polityk;3;1;2;11901;3967.00
pracownik budowlany;3;3;0;769;256.33
pracownik ochrony;3;3;0;1842;614.00
pilot wycieczek;3;1;2;1035;345.00
plastyk;3;2;1;1782;594.00
policjant;3;2;1;4061;1353.67
nauczyciel przedmiotów teoretycznych zawodowych;3;2;1;1278;426.00
nauczyciel akademicki - nauki inżynieryjno-techniczne;3;3;0;5140;1713.33
mgr inż. mechanik;2;2;0;2720;1360.00
nauczyciel bibliotekarz;2;0;2;1149;574.50
nauczyciel języka polskiego;2;1;1;6348;3174.00
nauczyciel fizyki i astronomii;2;1;1;5898;2949.00
nauczyciel kształcenia zawodowego;2;1;1;832;416.00
operator maszyn;2;2;0;1174;587.00
operator maszyn CNC;2;2;0;227;113.50
operator maszyn do obróbki skrawaniem;2;2;0;401;200.50
neurologopeda;2;1;1;3905;1952.50
nauczycielka akademicka - nauki społeczne;2;0;2;5927;2963.50
nauczyciel przedmiotów zawodowych technicznych;2;1;1;2967;1483.50
nauczyciel przedmiotów zawodowych;2;0;2;542;271.00
nauczyciel wychowania fizycznego;2;0;2;2889;1444.50
nauczyciel psycholog;2;0;2;855;427.50
pielęgniarz;2;2;0;1070;535.00
pisarz;2;1;1;8988;4494.00
pozostali dyrektorzy generalni i zarządzający;2;1;1;928;464.00
operator maszyn skrawających;2;2;0;23;11.50
prywatny przedsiębiorca;2;0;2;2881;1440.50
pracownik naukowy;2;2;0;1486;743.00
prawniczka;2;0;2;16082;8041.00
projektant grafiki;2;2;0;935;467.50
pracownik pomocniczy stolarza;2;0;2;652;326.00
pracownik produkcji;2;0;2;1016;508.00
pracownik fizyczny;2;1;1;467;233.50
pracownik galerii/muzeum;2;1;1;1395;697.50
pozostali specjaliści z dziedziny prawa gdzie indziej niesklasyfikowani;2;2;0;3155;1577.50
pracownik administracji rządowej;2;2;0;3484;1742.00
pracownik administracji biurowej;2;0;2;2289;1144.50
pracownik administracyjno biurowy;2;1;1;4526;2263.00
psycholog biznesu;2;1;1;2719;1359.50
przewodnik turystyczny;2;1;1;385;192.50
przedstawiciel władzy samorządowej (radny);2;1;1;5314;2657.00
przedstawiciel władzy samorządowej - radny;2;2;0;12149;6074.50
przedstawiciel władzy samorządowej - starosta;2;2;0;7486;3743.00
referent;2;1;1;1359;679.50
robotnik budowlany;2;2;0;1258;629.00
ratownik wodny;2;1;1;926;463.00
recepcjonista;2;2;0;914;457.00
recepcjonistka;2;0;2;983;491.50
redaktor;2;0;2;1145;572.50
redaktor naczelny;2;1;1;1080;540.00
rzeczoznawca majątkowy;2;0;2;3397;1698.50
rzemieślnik;2;1;1;796;398.00
specjalista ds. administracji;2;0;2;340;170.00
specjalista ds. marketingu i handlu;2;1;1;1767;883.50
specjalista ds. ochrony środowiska;2;2;0;1679;839.50
specjalista zdrowia publicznego;2;0;2;190;95.00
specjalista ds. wynagrodzeń;2;1;1;1028;514.00
specjalista administracji biurowej;2;1;1;335;167.50
specjalista zarządzania kryzysowego;2;1;1;10485;5242.50
sprzedawca branży spożywczej;2;0;2;327;163.50
student - bez zawodu;2;2;0;220;110.00
sprzedawca w branży spożywczej;2;1;1;444;222.00
statystyk medyczny;2;0;2;4266;2133.00
specjalista do spraw rachunkowości zarządczej;2;1;1;2815;1407.50
specjalista do spraw turystyki;2;1;1;796;398.00
specjalista ds. bhp;2;1;1;2097;1048.50
specjalista ds. administracji publicznej;2;0;2;2333;1166.50
specjalista ds. kadr;2;0;2;2264;1132.00
socjolożka;2;0;2;2483;1241.50
specjalista do spraw bezpieczeństwa wewnętrznego;2;0;2;690;345.00
technik serwisu;2;2;0;136;68.00
technik pożarnictwa;2;2;0;6984;3492.00
technik optyk;2;1;1;566;283.00
technik mechanizacji rolnictwa;2;2;0;580;290.00
technik mechatronik;2;2;0;944;472.00
technik farmaceutyczny;2;0;2;1310;655.00
technik handlowy;2;0;2;208;104.00
technik leśnik;2;2;0;514;257.00
student prawa;2;2;0;1876;938.00
technik bhp;2;1;1;601;300.50
technik budowy maszyn;2;2;0;372;186.00
technik drogownictwa;2;1;1;3230;1615.00
technik elektromechanik;2;2;0;1502;751.00
technik agrobiznesu;2;0;2;517;258.50
technik analityki medycznej;2;0;2;2137;1068.50
ślusarz;2;2;0;719;359.50
technik obsługi turystycznej;2;1;1;927;463.50
technik żywienia zbiorowego;2;2;0;5421;2710.50
tester oprogramowania komputerowego;2;1;1;1134;567.00
teleinformatyk;2;2;0;495;247.50
terapeuta;2;0;2;576;288.00
technik żywienia i gospodarstwa domowego;2;1;1;1017;508.50
windykator;2;0;2;835;417.50
"wizażystka; stylistka";2;0;2;860;430.00
tokarz;2;2;0;4183;2091.50
technik rolnictwa;2;1;1;1254;627.00
logopeda;2;2;0;945;472.50
kierownik, właściciel zakładu usługowego;2;1;1;2119;1059.50
mechanik automatyki przemysłowej i urządzeń precyzyjnych;2;1;1;2217;1108.50
magister inżynier budownictwa;2;2;0;3602;1801.00
kurator zawodowy;2;0;2;5905;2952.50
kucharka;2;0;2;204;102.00
koordynator projektów unijnych;2;1;1;845;422.50
maszynista;2;2;0;767;383.50
maszynista maszyn offsetowych;2;1;1;376;188.00
mechanik maszyn i urządzeń przemysłowych;2;2;0;881;440.50
mechanik samochodów osobowych;2;2;0;808;404.00
menedżer sportu;2;2;0;3611;1805.50
monter sieci wodnych i kanalizacyjnych;2;2;0;590;295.00
mikrobiolog;2;0;2;929;464.50
monter;2;2;0;1223;611.50
mgr ekonomii;2;0;2;2330;1165.00
mgr inż. rolnictwa;2;0;2;6721;3360.50
inżynier telekomunikacji;2;2;0;2092;1046.00
kelner;2;1;1;1161;580.50
kamieniarz;2;2;0;177;88.50
inżynier technolog;2;2;0;1381;690.50
inżynier produkcji;2;2;0;908;454.00
inżynier ogrodnictwa;2;0;2;1725;862.50
inżynier organizacji i planowania produkcji;2;2;0;651;325.50
inżynier górnik - górnictwo podziemne;2;2;0;834;417.00
inżynier informatyk;2;1;1;4733;2366.50
inżynier energetyki;2;1;1;2744;1372.00
inżynier geodeta;2;1;1;4609;2304.50
inżynier logistyki;2;2;0;578;289.00
inżynier mechanik - środki transportu;2;2;0;2667;1333.50
konserwator;2;2;0;443;221.50
kolejarz;2;1;1;635;317.50
kierownik lokalu gastronomicznego;2;1;1;461;230.50
kierownik małego przedsiębiorstwa budowlanego;2;1;1;899;449.50
kierownik przedsiębiorstwa świadczącego usługi z zakresu obsługi biznesu;2;2;0;902;451.00
kierownik sprzedaży;2;1;1;306;153.00
kierowca mechanik;2;2;0;561;280.50
kierowca samochodu dostawczego;2;2;0;1342;671.00
kierownik ds. marketingu;2;2;0;3261;1630.50
kierownik hotelu;2;2;0;619;309.50
fryzjerka;2;0;2;1223;611.50
florysta;2;0;2;1805;902.50
emerytowany nauczyciel;2;0;2;1299;649.50
etnograf;2;2;0;2817;1408.50
dyrektor wykonawczy;2;2;0;1404;702.00
elektromonter instalacji elektrycznych;2;2;0;1583;791.50
elektroradiolog;2;1;1;1014;507.00
"ekonomista; urzędnik";2;1;1;2987;1493.50
inżynier chemii;2;2;0;420;210.00
instruktor higieny;2;2;0;3589;1794.50
inspektor bezpieczeństwa i higieny pracy;2;2;0;1155;577.50
inspektor ochrony danych;2;1;1;2997;1498.50
grafik komputerowy dtp;2;0;2;681;340.50
grafik komputerowy multimediów;2;1;1;431;215.50
groomer;2;0;2;828;414.00
gospodyni;2;0;2;490;245.00
gospodyni domowa;2;0;2;2789;1394.50
bibliotekoznawca;2;0;2;1850;925.00
bankowiec;2;0;2;488;244.00
barman;2;1;1;4900;2450.00
doradca handlowy;2;1;1;2559;1279.50
diagnosta laboratoryjny;2;1;1;3865;1932.50
doradca do spraw rynku nieruchomości;2;2;0;2579;1289.50
broker ubezpieczeniowy;2;2;0;2907;1453.50
dyrektor domu kultury;2;1;1;671;335.50
dyrektor ds. administracyjnych;2;1;1;7906;3953.00
doradca restrukturyzacyjny;2;1;1;4620;2310.00
doradca rolniczy;2;1;1;1346;673.00
doradca zawodowy;2;0;2;3546;1773.00
drukarz;2;1;1;1045;522.50
asystent nauczyciela przedszkola;2;0;2;1459;729.50
audytor/kontroler;2;2;0;427;213.50
audytor;2;2;0;681;340.50
audytor energetyczny;2;2;0;2263;1131.50
asystent parlamentarny;2;1;1;1083;541.50
animator;2;0;2;1740;870.00
artysta;2;1;1;1204;602.00
artysta grafik;2;0;2;1098;549.00
artysta malarz;2;1;1;362;181.00
analityk medyczny;2;0;2;412;206.00
analityk bankowy;2;1;1;2097;1048.50
agent celny;2;1;1;862;431.00
agent do spraw zakupów;1;0;1;300;300.00
analityk baz danych (data scientist);1;1;0;318;318.00
analityk gospodarczy;1;1;0;1966;1966.00
analityk ds. ubezpieczeń;1;1;0;526;526.00
analityk spraw międzynarodowych;1;0;1;887;887.00
analityk systemów komputerowych;1;0;1;1527;1527.00
andragog;1;0;1;744;744.00
animator rekreacji i organizacji czasu wolnego;1;1;0;571;571.00
animatorka kultury;1;0;1;2190;2190.00
aparatowy przetwórstwa mięsa;1;1;0;1769;1769.00
arborysta;1;1;0;256;256.00
aktuariusz;1;1;0;400;400.00
analityczka biznesowa;1;0;1;7968;7968.00
agentka ubezpieczeniowa;1;0;1;1016;1016.00
agronom;1;0;1;462;462.00
akredytowany asystent parlamentarny;1;1;0;443;443.00
administrator osiedla;1;1;0;590;590.00
administrator systemów komputerowych;1;1;0;931;931.00
administator nieruchomości;1;0;1;1923;1923.00
administrator bezpieczeństwa informacji (inspektor ochrony danych);1;1;0;1477;1477.00
administratywistka;1;0;1;519;519.00
adwokatka;1;0;1;2763;2763.00
artysta plastyk - scenograf;1;1;0;374;374.00
artysta rzemieślnik;1;1;0;233;233.00
artysta rzeźbiarz;1;0;1;81;81.00
artysta sztuki;1;0;1;152;152.00
artysta-malarka;1;0;1;1103;1103.00
asystent księgowego;1;1;0;66;66.00
asystent nauczyciela;1;0;1;196;196.00
architekt systemów teleinformatycznych;1;1;0;383;383.00
architektka wnętrz;1;0;1;4374;4374.00
archiwista;1;1;0;156;156.00
audytor kontroler;1;1;0;971;971.00
audytor środowiskowy;1;1;0;700;700.00
automatyk sterowania ruchem kolejowym;1;1;0;228;228.00
automatyk-elektronik;1;1;0;149;149.00
asystent przetwarzania danych;1;0;1;326;326.00
asystent psychologa;1;0;1;703;703.00
asystent rodziny;1;0;1;179;179.00
asystent sędziego;1;0;1;122;122.00
asystent stomatologa;1;0;1;218;218.00
asystent szkoleniowca planowego;1;0;1;198;198.00
asystent zarządu;1;0;1;952;952.00
asystentka prawna;1;0;1;646;646.00
asystentka projektanta dróg;1;0;1;2028;2028.00
asystentka stomatologiczna;1;0;1;254;254.00
asysystent parlamentarny;1;1;0;2347;2347.00
drukarz sitodrukowy;1;1;0;393;393.00
dyplomata;1;1;0;665;665.00
dyplomowany opiekun medyczny;1;0;1;1449;1449.00
dorodca podatkowy;1;1;0;172;172.00
dozorca;1;1;0;160;160.00
dr ekonomii;1;0;1;4744;4744.00
dr inż. ds. rolnictwa ochrony środowiska;1;0;1;847;847.00
dróżnik przejazdowy;1;1;0;349;349.00
doradca rolny;1;1;0;540;540.00
doradca techniczno-handlowy;1;1;0;206;206.00
doradca techniczny;1;1;0;1035;1035.00
doradca ubezpieczeniowy;1;0;1;173;173.00
doradca rodzinny;1;0;1;2607;2607.00
doradca polityczny i publiczny;1;0;1;2388;2388.00
dyrektor ds. badawczo-rozwojowych;1;1;0;1038;1038.00
dyrektor biura poselskiego;1;1;0;784;784.00
dyrektor departamentu;1;1;0;7329;7329.00
dyrektor do spraw cyberbezpieczeństwa;1;1;0;456;456.00
dyrektor do spraw informatyki i informacji;1;1;0;46;46.00
dyrektor ośrodka sportu i rekreacji;1;0;1;3154;3154.00
dyrektor placówki oświatowej;1;0;1;1053;1053.00
dyrektor muzeum;1;0;1;1157;1157.00
dyrektor logistyki;1;1;0;985;985.00
dyrektor gliwickiego centrum edukacyjno-rehabilitacyjnego;1;0;1;971;971.00
doradca energetyczny;1;0;1;423;423.00
diagnosta pojazdów;1;1;0;907;907.00
diagnosta samochodowy;1;1;0;746;746.00
doradca inwestycyjny;1;1;0;343;343.00
doradca klienta biznesowego;1;0;1;237;237.00
doradca personalny;1;1;0;97;97.00
doktor nauk medycznych kardiolog;1;1;0;1192;1192.00
doktor nauk o zdrowiu;1;0;1;469;469.00
doktor nauk prawnych;1;0;1;1321;1321.00
doradca do spraw finansowych;1;0;1;410;410.00
członek zarządu;1;1;0;1229;1229.00
cieśla;1;1;0;1754;1754.00
copywriter;1;0;1;758;758.00
betoniarz - zbrojarz;1;1;0;108;108.00
betoniarz-zbrojarz;1;1;0;27;27.00
bankowiec-starszy referent;1;0;1;396;396.00
barber;1;0;1;184;184.00
bezrobotna;1;0;1;344;344.00
bezrobotny;1;1;0;176;176.00
bloger;1;1;0;249;249.00
brak zawodu;1;1;0;296;296.00
brakarz ds. emisji zanieczyszczeń;1;1;0;258;258.00
burmistrz;1;0;1;2497;2497.00
ceramik wyrobów użytkowych i ozdobnych;1;0;1;422;422.00
biochemik;1;0;1;875;875.00
główny specjalista ds. administracji;1;1;0;666;666.00
główny specjalista w instytucie badawczym;1;1;0;5065;5065.00
glazurnik;1;1;0;470;470.00
główna księgowa;1;0;1;1691;1691.00
główny energomechanik;1;0;1;82;82.00
górnik elektryk;1;1;0;731;731.00
górnik-ratownik górniczy;1;1;0;597;597.00
inspektor ochrony danych osobowych;1;1;0;202;202.00
inspektor ochrony przeciwpożarowej;1;1;0;345;345.00
inspektor ochrony środowiska;1;0;1;2063;2063.00
inspektor sanitarny;1;0;1;75;75.00
instruktor ds. artystycznych;1;1;0;1764;1764.00
instruktor fitness;1;0;1;694;694.00
inspektor BHP;1;1;0;740;740.00
inspektor budowlany;1;1;0;209;209.00
inspektor ds. ochrony przeciwpożarowej;1;1;0;1349;1349.00
inspektor nadzoru budowlanego;1;1;0;470;470.00
inspektor nadzoru inwestorskiego;1;1;0;220;220.00
informatyk medyczny;1;1;0;1391;1391.00
inspektor administracji;1;0;1;270;270.00
hodowca bydła;1;1;0;251;251.00
hodowca zwierząt egzotycznych;1;1;0;444;444.00
hotelarz;1;0;1;483;483.00
hydraulik;1;1;0;130;130.00
hydrolog;1;0;1;6319;6319.00
instruktor nauki jazdy kat. b;1;1;0;209;209.00
instruktor rekreacji ruchowej;1;1;0;452;452.00
instruktor terapii uzależnień;1;1;0;513;513.00
instruktorka kultury;1;0;1;285;285.00
instrumentalista;1;1;0;346;346.00
inż. automatyk;1;1;0;1279;1279.00
inż. chemik;1;1;0;289;289.00
inż. elektrotechniki;1;1;0;1889;1889.00
inż. elektryk;1;1;0;6526;6526.00
inż. gospodarki przestrzennej;1;1;0;381;381.00
inż. inżynierii środowiska;1;1;0;369;369.00
inż. nauk technicznych;1;1;0;584;584.00
inż. rolnik;1;0;1;766;766.00
inż. włókiennik;1;0;1;489;489.00
inż. zarządzania środowiskiem;1;1;0;230;230.00
inż. zootechnik;1;1;0;440;440.00
inżynier chemik kierownik projektu;1;1;0;920;920.00
inżynier drogownictwa;1;1;0;407;407.00
inżynier ds. technicznych;1;1;0;1220;1220.00
inżynier ekoenergetyki;1;1;0;2269;2269.00
inżynier elektrotechnik;1;1;0;1422;1422.00
inżynier elektrotechniki;1;1;0;3075;3075.00
inżynier budowy mostów;1;1;0;685;685.00
inżynier budownictwa lądowego;1;0;1;565;565.00
inżynier biomedyczny;1;1;0;128;128.00
inżynier budowlany;1;1;0;164;164.00
inżynier architekt wnętrz;1;0;1;4553;4553.00
ekonomista-przedsiębiorca;1;1;0;1305;1305.00
elektrotechnik;1;1;0;119;119.00
elektromonter urządzeń sygnalizacyjnych;1;1;0;267;267.00
ekonomista menedżer;1;0;1;749;749.00
ekspert ds. bezpieczeństwa;1;1;0;816;816.00
ekspert ds. energetyki morskiej;1;1;0;5818;5818.00
ekspert ds. standaryzacji;1;1;0;3638;3638.00
ekspert finansowy;1;1;0;260;260.00
ekspert w administracji publicznej;1;0;1;2389;2389.00
elektroenergetyk;1;1;0;3541;3541.00
dyrektor samorządowej instytucji kultury;1;1;0;1244;1244.00
dyrektor SP ZOZ Żukowo;1;0;1;941;941.00
dyrektor spółki;1;1;0;882;882.00
dyrektor w instytucji opieki nad dziećmi;1;0;1;841;841.00
dyrektor szkoły, nauczyciel-pedagog;1;0;1;772;772.00
dyrektor zarządzający sektora turystyki;1;1;0;1787;1787.00
dyrektor-ekonomista;1;1;0;1418;1418.00
działalność gospodarcza;1;1;0;558;558.00
egzaminator;1;1;0;3490;3490.00
ekolog;1;0;1;2816;2816.00
ekonometryk;1;0;1;879;879.00
etnolog;1;0;1;15;15.00
emerytowany żołnierz;1;1;0;200;200.00
epidemiolog;1;0;1;1994;1994.00
farmaceutka;1;0;1;2072;2072.00
filolog;1;1;0;303;303.00
filolog języka francuskiego i hiszpańskiego;1;0;1;701;701.00
emaliernik;1;0;1;658;658.00
emerytowany funkcjonariusz straży granicznej;1;1;0;154;154.00
emerytowany komendant policji;1;1;0;751;751.00
emeryt mundurowy;1;1;0;264;264.00
emeryt policyjny;1;1;0;328;328.00
emeryt rencista;1;1;0;322;322.00
emeryt/rencista wojskowy;1;1;0;3075;3075.00
florystka;1;0;1;400;400.00
fototechnik;1;0;1;1044;1044.00
genetyk;1;0;1;1965;1965.00
fryzjer męski;1;0;1;178;178.00
filozofka;1;0;1;200;200.00
finansista;1;0;1;248;248.00
finansistka;1;0;1;1852;1852.00
fizjolog;1;0;1;386;386.00
filolog klasyczny;1;1;0;136;136.00
fizjoterapeutka;1;0;1;244;244.00
kierownik komórki organizacyjnej podmiotu leczniczego;1;1;0;882;882.00
kierownik ds. technologii;1;0;1;644;644.00
kierownik ds. usług turystycznych sektor prywatny;1;0;1;844;844.00
kierownik ośrodka pomocy społecznej;1;0;1;931;931.00
kierownik placówki bankowej;1;1;0;1500;1500.00
kierownik placówki opiekuńczo-wychowawczej;1;0;1;357;357.00
kierownik placówki wsparcia dziennego;1;0;1;1348;1348.00
kierownik działu badawczo-rozwojowego;1;0;1;748;748.00
kierownik działu hotelu;1;1;0;315;315.00
kierownik działu kadr i płac;1;0;1;9463;9463.00
kierownik działu logistyki;1;0;1;241;241.00
kierownik działu promocji;1;0;1;400;400.00
kierownik działu sprzedaży;1;1;0;83;83.00
kierownik działu szkoleń;1;0;1;268;268.00
kierownik działu w domu pomocy społecznej;1;1;0;409;409.00
kierownik działu w hotelu;1;1;0;410;410.00
kierownik działu w instytucjach pomocy społecznej;1;0;1;5224;5224.00
kierownik działu zarządzania zasobami ludzkimi;1;0;1;384;384.00
kierownik gospodarstwa upraw polowych;1;0;1;631;631.00
kierowca samochodu osobowego;1;1;0;210;210.00
kierownik domu pomocy społecznej;1;1;0;793;793.00
kierownik budowy;1;1;0;248;248.00
kierownik do spraw marketingu;1;1;0;384;384.00
kierowca/operator wózków jezdniowych;1;1;0;417;417.00
kierowca-mechanik;1;1;0;128;128.00
kierownik;1;0;1;1442;1442.00
kierownik agencji doradztwa finansowego;1;0;1;610;610.00
kierownik agencji ds. usług turystycznych;1;0;1;1734;1734.00
kierownik agencji ochrony;1;1;0;2544;2544.00
kierownik biblioteki;1;1;0;2455;2455.00
kierownik sprzedaży wewnętrznej;1;0;1;1683;1683.00
kierownik utrzymania ruchu;1;1;0;243;243.00
kierownik wydziału;1;0;1;447;447.00
kierownik zakupowy;1;1;0;617;617.00
kierownik zespołu;1;1;0;270;270.00
kierownik przedsiębiorstwa transportowego;1;0;1;1349;1349.00
kierownik przedszkola;1;0;1;1042;1042.00
kierownik recepcji;1;0;1;587;587.00
kierownik regionalny;1;1;0;3329;3329.00
kierownik schroniska dla bezdomnych zwierząt;1;0;1;627;627.00
kierownik muzeum;1;0;1;1018;1018.00
kierownik przedsiębiorstwa informatycznego;1;1;0;173;173.00
kierownik pomocy społecznej;1;0;1;722;722.00
kierownik produkcji w przemyśle;1;1;0;8332;8332.00
kierownik projektów;1;0;1;805;805.00
kierownik projektów społecznych;1;0;1;1538;1538.00
komendant wojewódzki OHP;1;1;0;3143;3143.00
konduktor;1;1;0;335;335.00
konserwator dzieł sztuki;1;0;1;460;460.00
konserwator muzealnik;1;0;1;239;239.00
kierownik sklepu/supermarketu;1;0;1;902;902.00
konstruktor prototypów wiązek elektrycznych;1;1;0;2813;2813.00
konsultant agent sprzedaży bezpośredniej;1;1;0;567;567.00
konsultant do spraw systemów informatycznych;1;1;0;340;340.00
konsultant podatkowy;1;1;0;1885;1885.00
kontroler;1;0;1;239;239.00
kontroler jakości;1;0;1;156;156.00
kontroler jakości wyrobów przemysłowych;1;1;0;814;814.00
kontroler NIK;1;1;0;1279;1279.00
kontroler projektów;1;0;1;407;407.00
koordynator ds. sprzedaży;1;0;1;202;202.00
inżynier mechanik - technologia mechaniczna;1;1;0;340;340.00
inżynier mechanik górnictwa;1;1;0;283;283.00
inżynier mechanik środków transportu;1;1;0;1632;1632.00
inżynier mechanik, maszyny i urządzenia przemysłowe;1;1;0;3740;3740.00
inżynier mechaniki i budowy maszyn;1;1;0;397;397.00
inżynier mechanizacji;1;1;0;583;583.00
inżynier mechanizacji rolnictwa;1;1;0;798;798.00
inżynier machanik;1;1;0;383;383.00
inżynier materiałów inżynierskich i biomedycznych;1;0;1;279;279.00
inżynier logistyk;1;1;0;2649;2649.00
inżynier inżynierii środowiska - gospodarka wodna i hydrologia;1;1;0;422;422.00
inżynier inżynierii środowiska - instalacje sanitarne;1;1;0;248;248.00
inżynier inżynierii środowiska - oczyszczanie miasta i gosp. odpadami;1;1;0;1007;1007.00
inżynier konstruktor;1;1;0;37;37.00
inżynier kształtowania środowiska;1;1;0;4401;4401.00
inżynier geodeta - geomatyka;1;1;0;297;297.00
inżynier geolog - geologia górnicza i poszukiwawcza;1;1;0;257;257.00
inżynier gospodarki przestrzennej;1;0;1;81;81.00
inżynier górnictwa;1;1;0;803;803.00
inżynier informatyki;1;1;0;204;204.00
inżynier instalacji sanitarnych - środowiska;1;1;0;427;427.00
inżynier inżynierii kosmicznej i satelitarnej;1;0;1;9175;9175.00
inżynier inżynierii materiałowej;1;1;0;1050;1050.00
inżynier górnik-górnictwo podziemne;1;1;0;537;537.00
inżynier hutnik;1;0;1;738;738.00
inżynier mechanik - maszyny i urządzenia do obróbki metali;1;1;0;236;236.00
inżynier mechanik - maszyny i urządzenia przemysłowe;1;1;0;863;863.00
inżynier programista;1;1;0;664;664.00
inżynier projektant;1;1;0;245;245.00
inżynier pożarnictwa-strażak;1;1;0;5677;5677.00
inżynier procesów produkcyjnych;1;0;1;1165;1165.00
inżynier techniczno-handlowy;1;1;0;248;248.00
inżynier systemu;1;1;0;266;266.00
kapitan żeglugi śródlądowej;1;0;1;680;680.00
kartograf;1;1;0;2070;2070.00
kasjer - sprzedawca;1;0;1;467;467.00
kasjer handlowy;1;0;1;91;91.00
katecheta;1;1;0;299;299.00
kelnerka;1;0;1;247;247.00
kierowca autobusu;1;1;0;134;134.00
inżynier-elektronik;1;1;0;195;195.00
inżynierka nauk medycznych;1;0;1;492;492.00
inżynier transportu kolejowego;1;1;0;389;389.00
inżynier wsparcia IT;1;1;0;118;118.00
inżynier zielarstwa;1;0;1;943;943.00
mgr inż. transportu;1;0;1;561;561.00
mgr inż. zarządzania;1;1;0;248;248.00
mgr inż. zootechnik;1;1;0;7821;7821.00
mgr inż. zootechniki;1;0;1;3572;3572.00
mgr logistyki w biznesie;1;0;1;511;511.00
mgr ochrony środowiska;1;0;1;430;430.00
mgr prawa;1;1;0;1029;1029.00
miejski rzecznik konsumentów;1;1;0;1095;1095.00
mgr filologii polskiej;1;1;0;985;985.00
mgr inż. budownictwa;1;0;1;1635;1635.00
mgr inż. budownictwa - budownictwo ogólne;1;0;1;1645;1645.00
mgr inż. budownictwa lądowego;1;1;0;95;95.00
mgr inż. elektronik;1;1;0;482;482.00
mgr inż. elektroniki i telekomunikacji;1;1;0;625;625.00
mgr inż. elektryk;1;1;0;568;568.00
mgr inż. elektryk automatyka i sterowanie;1;1;0;50;50.00
monter elektronik;1;1;0;184;184.00
monter instalacji klimatyczno-wentylacyjnej;1;1;0;197;197.00
monter mebli;1;1;0;131;131.00
monter reklam;1;1;0;152;152.00
mikrotechnolog;1;0;1;593;593.00
modelka;1;0;1;1387;1387.00
montażysta obrazu;1;1;0;146;146.00
monter systemów klimatyzacji;1;1;0;488;488.00
monter ślusarskiego wyposażenia okrętowego;1;1;0;28;28.00
motorniczy;1;0;1;195;195.00
muzyk instrumentalista;1;0;1;1083;1083.00
muzykolog;1;0;1;64;64.00
naczelnik poczty;1;0;1;371;371.00
naczelnik wydziału w administracji państwowej;1;1;0;498;498.00
nadsztygar;1;1;0;634;634.00
naturopata;1;0;1;218;218.00
menedżerka kultury;1;0;1;1677;1677.00
mgr administracji;1;0;1;387;387.00
menedżer / pracownik samorządowy;1;1;0;2401;2401.00
menedżer gastronomii;1;0;1;574;574.00
menedżer kultury;1;1;0;1492;1492.00
menedżer marki;1;1;0;2797;2797.00
mechanizator rolnictwa;1;1;0;2163;2163.00
mechatronik;1;1;0;38;38.00
mediator sądowy;1;1;0;237;237.00
mediator, magister animacji społeczno-kulturalnej;1;0;1;646;646.00
meliorant;1;0;1;244;244.00
mechanik samochodów ciężarowych;1;1;0;1071;1071.00
menager finansowy;1;0;1;199;199.00
menager zarządzania;1;1;0;467;467.00
mechanik maszyn przemysłowych;1;1;0;268;268.00
mechanik maszyn rolniczych;1;1;0;704;704.00
mechanik okrętowy;1;1;0;400;400.00
matematyk;1;0;1;2463;2463.00
menadżer ds. public relations;1;0;1;1648;1648.00
menadżer energia odnawialna;1;1;0;551;551.00
menadżer hotelarstwa;1;0;1;838;838.00
menadżer kultury;1;1;0;2308;2308.00
menadżer marki;1;1;0;305;305.00
menadżer ochrony zdrowia;1;0;1;2692;2692.00
menadżer projektów;1;1;0;1474;1474.00
menadżer sportu;1;1;0;817;817.00
menadżerka;1;0;1;883;883.00
koordynator sprzedaży;1;1;0;631;631.00
korektor językowy;1;0;1;1301;1301.00
korepetytor;1;0;1;439;439.00
kosztorysant budowlany;1;1;0;550;550.00
kosmetolożka;1;0;1;4058;4058.00
krytyk artystyczny;1;0;1;358;358.00
kulturoznawczyni;1;0;1;1019;1019.00
kucharz małej gastronomii;1;1;0;260;260.00
kynoterapeuta;1;0;1;168;168.00
laborant;1;0;1;317;317.00
laborant chemiczny;1;0;1;72;72.00
lakiernik;1;1;0;297;297.00
lakiernik proszkowy;1;1;0;396;396.00
legislator;1;0;1;685;685.00
lekarz - specjalista gastroenterologii;1;0;1;1604;1604.00
lekarz - specjalista kardiologii;1;1;0;5441;5441.00
lekarz - specjalista medycyny rodzinnej;1;1;0;575;575.00
lekarz - specjalista psychiatra;1;1;0;771;771.00
lekarz  weterynarii;1;1;0;4947;4947.00
lekarz dentysta - specjalista chirurgii stomatologicznej;1;1;0;2143;2143.00
lekarz dentysta ze specjalizacją I stopnia;1;0;1;604;604.00
lekarz dermatolog;1;0;1;1842;1842.00
lekarz specjalista anestezjologii i intensywnej terapii;1;0;1;138;138.00
lekarz specjalista chirurgii ogólnej;1;1;0;430;430.00
lekarz specjalista chorób płuc;1;1;0;1356;1356.00
magister inżynier górnik;1;1;0;552;552.00
magister inżynier leśnictwa;1;0;1;6086;6086.00
magister inżynier mechanik;1;1;0;734;734.00
magister inżynier ochrony środowiska;1;1;0;3477;3477.00
magister inżynier rolnictwa;1;0;1;1377;1377.00
magister inżynier technologii żywności;1;0;1;3689;3689.00
magister inżynier zarządzania;1;0;1;972;972.00
magister pielęgniarstwa;1;0;1;1585;1585.00
magister polonistyki metodyk nauczania języka polskiego;1;0;1;4671;4671.00
magister zarządzania;1;0;1;1058;1058.00
makler papierów wartościowych;1;1;0;545;545.00
malarz;1;1;0;308;308.00
mechanik ciągników;1;1;0;354;354.00
mechanik maszyn i urządzeń;1;1;0;167;167.00
mechanik maszyn i urządzeń górnictwa podziemnego;1;1;0;1156;1156.00
manager exportu;1;0;1;441;441.00
manager sportu;1;1;0;282;282.00
marynarz żeglugi śródlądowej;1;1;0;922;922.00
masarz;1;1;0;629;629.00
masażysta;1;0;1;91;91.00
lekarz-specjalista chorób wewnętrznych;1;1;0;1552;1552.00
lektor języka angielskiego;1;1;0;448;448.00
lektor języka niemieckiego;1;0;1;239;239.00
łowczy okręgowy;1;1;0;394;394.00
logistyk mgr;1;1;0;34;34.00
magister ekonomii;1;1;0;4397;4397.00
magister farmacji;1;1;0;294;294.00
urbanista;1;1;0;192;192.00
urzędniczka;1;0;1;868;868.00
urzędnik administracji państwowej;1;1;0;3124;3124.00
urzędnik administracji publicznej;1;1;0;2515;2515.00
urzędnik do spraw licencji;1;1;0;4645;4645.00
towaroznawca;1;1;0;176;176.00
tłumacz języka rosyjskiego;1;0;1;411;411.00
tłumaczka;1;0;1;17629;17629.00
trener osobisty (coach);1;0;1;228;228.00
trener pływania;1;1;0;334;334.00
trener sportowy;1;1;0;1347;1347.00
własna działalność gospodarcza;1;0;1;579;579.00
wirusolog;1;1;0;617;617.00
urzędnik samorządowy - skarbnik;1;0;1;711;711.00
urzędnik ubezpieczeń społecznych;1;0;1;202;202.00
weterynarz;1;1;0;971;971.00
wicewojewoda małopolski;1;1;0;6329;6329.00
wideo filmowiec;1;1;0;134;134.00
właścicielka sklepu;1;0;1;863;863.00
włókiennik;1;1;0;337;337.00
woźny;1;1;0;359;359.00
wójt;1;1;0;4998;4998.00
wychowawca w instytucji pieczy zastępczej;1;0;1;782;782.00
wychowawca w placówce opiekuńczej;1;1;0;648;648.00
wychowawca w placówkach oświatowych;1;0;1;819;819.00
technolog żywności i żywienia człowieka;1;1;0;100;100.00
technik wiertnik;1;1;0;866;866.00
technik utrzymania ruchu;1;1;0;895;895.00
terapeuta środowiskowy;1;1;0;293;293.00
terapeuta uzależnień;1;0;1;74;74.00
telemarketer;1;1;0;365;365.00
technik-ekonomista;1;0;1;845;845.00
technolog;1;1;0;1888;1888.00
technolog - programista obrabiarek;1;1;0;498;498.00
technolog spożywczy;1;1;0;681;681.00
technolog żywienia;1;1;0;70;70.00
technolog żywienia zbiorowego;1;0;1;135;135.00
technik ochrony osób mienia;1;0;1;197;197.00
technik ochrony roślin;1;0;1;1778;1778.00
technik technologii żywienia;1;1;0;141;141.00
technik telekomunikacyjny;1;1;0;608;608.00
technik transportu kolejowego;1;0;1;81;81.00
technik turystyki;1;0;1;1313;1313.00
technik urządzeń i systemów energetyki odnawialnej;1;1;0;865;865.00
ślusarz-mechanik;1;1;0;470;470.00
ślusarz-spawacz;1;1;0;2206;2206.00
taksówkarz;1;1;0;172;172.00
tartacznik;1;1;0;1756;1756.00
tatuażystka;1;0;1;1852;1852.00
teatrolog;1;0;1;1883;1883.00
technik - mechanik;1;1;0;7756;7756.00
technik architekt;1;0;1;252;252.00
technik architektury;1;0;1;57;57.00
technik administracji publicznej;1;0;1;201;201.00
szef ds. załadunków;1;1;0;17;17.00
technik elektroenergetyk;1;1;0;227;227.00
technik ekg;1;0;1;580;580.00
technik ekonomii;1;0;1;348;348.00
technik dietetyk;1;0;1;183;183.00
technik chemik;1;0;1;778;778.00
technik cukiernictwa;1;0;1;188;188.00
technik budowy dróg i mostów;1;0;1;245;245.00
technik bankowy;1;0;1;55;55.00
technik bezpieczeństwa i higieny pracy;1;1;0;625;625.00
technik inżynierii środowiska i melioracji;1;0;1;1668;1668.00
technik laboratoryjny;1;0;1;403;403.00
technik mechanik maszyn i urządzeń;1;1;0;656;656.00
technik mechanik maszyn i urządzeń górnictwa podziemnego;1;1;0;8126;8126.00
technik mechanik samochodowy;1;1;0;94;94.00
technik mechanik sp. obróbki skrawaniem;1;1;0;122;122.00
technik mechanik urządzeń przemysłowych;1;1;0;203;203.00
technik hodowca koni;1;1;0;857;857.00
technik hotelarz;1;0;1;2139;2139.00
technik gastronom;1;0;1;362;362.00
technik górnik;1;0;1;623;623.00
technik energetyki;1;1;0;4567;4567.00
technik nawigator;1;1;0;397;397.00
technik mechanizacji rolnictwa i agrotroniki;1;1;0;335;335.00
technik ortopedyczny;1;1;0;96;96.00
technik pojazdów samochodowych;1;1;0;314;314.00
technik poligrafii;1;1;0;806;806.00
technik prac biurowych;1;0;1;1006;1006.00
technik programista;1;1;0;926;926.00
technik rachunkowości;1;0;1;2451;2451.00
technik spedytor;1;1;0;290;290.00
technik technologii drewna;1;1;0;766;766.00
specjalista do spraw BHP;1;1;0;227;227.00
specjalista do spraw cyberbezpieczeństwa;1;1;0;1401;1401.00
specjalista do spraw eksportu;1;0;1;1766;1766.00
specjalista do spraw finansowych;1;0;1;141;141.00
specjalista do spraw integracji europejskiej;1;1;0;246;246.00
specjalista do spraw jakości oprogramowania;1;0;1;2303;2303.00
specjalista bezpieczeństwa i higieny pracy;1;1;0;341;341.00
specjalista bhp i ochrony środowiska;1;0;1;754;754.00
specjalista d/s rekrutacji opiekun klienta;1;0;1;260;260.00
specjalista d/s rozliczeń z Narodowym Funduszem Zdrowia;1;0;1;1319;1319.00
specjalista do spraw administracji i logistyki;1;1;0;530;530.00
specjalista administracji;1;1;0;610;610.00
sekretarka medyczna;1;0;1;913;913.00
sekretarz gminy;1;0;1;1281;1281.00
sekretarz sądowy;1;0;1;640;640.00
serwisant urządzeń biurowych;1;1;0;312;312.00
sędzia sportowy;1;1;0;2137;2137.00
specjalista do spraw marketingu i reklamy;1;0;1;777;777.00
specjalista do spraw marketingu i social media;1;0;1;440;440.00
specjalista do spraw mediów;1;0;1;727;727.00
specjalista do spraw mediów interaktywnych;1;0;1;997;997.00
specjalista do spraw mediów społecznościowych;1;0;1;148;148.00
specjalista do spraw nieruchomości;1;0;1;1376;1376.00
specjalista do spraw obsługi projektów i programów;1;1;0;673;673.00
specjalista do spraw organizacji i zarządzania w ochronie zdrowia;1;0;1;488;488.00
specjalista do spraw organizacji usług gastronomicznych, hotelowych i turystycznych;1;0;1;1032;1032.00
specjalista do spraw pozyskiwania funduszy (fundraiser);1;0;1;1907;1907.00
specjalista do spraw produkcji;1;1;0;3224;3224.00
specjalista do spraw administracji publicznej;1;0;1;769;769.00
specjalista do spraw badań i rozwoju;1;1;0;552;552.00
specjalista do spraw kluczowych klientów;1;1;0;251;251.00
specjalista do spraw komunikacji społecznej;1;0;1;592;592.00
specjalista do spraw kontrolingu;1;0;1;5508;5508.00
specjalista ds. kadr i płac;1;0;1;173;173.00
specjalista ds. komunikacji;1;1;0;415;415.00
specjalista ds. komunikacji i wizerunku;1;0;1;362;362.00
specjalista ds. księgowości i rachunkowości;1;0;1;182;182.00
specjalista ds. bezpieczeństwa;1;1;0;937;937.00
specjalista ds. bezpieczeństwa i higieny pracy;1;1;0;523;523.00
specjalista ds. bezpieczeństwa narodowego;1;1;0;1537;1537.00
specjalista ds. bibliotecznych;1;0;1;174;174.00
specjalista ds. elektrycznych;1;1;0;268;268.00
specjalista ds. finansowych;1;1;0;665;665.00
specjalista ds. finansów publicznych;1;0;1;967;967.00
specjalista ds. grafiki;1;0;1;1490;1490.00
specjalista ds. integracji europejskiej;1;0;1;3038;3038.00
specjalista ds. jakości oprogramowania;1;1;0;1519;1519.00
specjalista do spraw ubezpieczeń majątkowych i osobowych;1;1;0;402;402.00
specjalista do spraw wodno-kanalizacyjnych;1;1;0;187;187.00
specjalista do spraw zamówień publicznych;1;1;0;74;74.00
specjalista do spraw zarządzania zasobami ludzkimi;1;0;1;1075;1075.00
specjalista do spraw zintegrowanych systemów zarządzania;1;0;1;2246;2246.00
specjalista do zastosowań informatyki;1;1;0;403;403.00
specjalista do spraw ratownictwa medycznego;1;1;0;354;354.00
specjalista do spraw reklamy;1;1;0;226;226.00
specjalista do spraw reklamy i marketingu;1;1;0;111;111.00
specjalista do spraw rekrutacji pracowników;1;0;1;279;279.00
specjalista do spraw rozliczeń i kadr;1;0;1;206;206.00
specjalista do spraw rozwoju oprogramowania systemów informatycznych;1;0;1;372;372.00
specjalista do spraw socjalnych;1;1;0;11716;11716.00
steward;1;1;0;135;135.00
stewardesa;1;0;1;261;261.00
sprzedawca-magazynier;1;1;0;389;389.00
sprzedawczyni;1;0;1;128;128.00
starszy archiwista;1;0;1;322;322.00
starszy inspektor bhp;1;0;1;259;259.00
starszy konsultant ds. organizacji przedsiębiorstwa;1;1;0;153;153.00
starszy menedżer do spraw analizy finansowej;1;1;0;481;481.00
statystyk;1;1;0;410;410.00
student elektroradiologii;1;1;0;58;58.00
student inżynierii zarządzania;1;1;0;97;97.00
strażnik leśny;1;1;0;365;365.00
strażnik SOK;1;1;0;116;116.00
stolarz budowlany;1;1;0;688;688.00
stomatolog;1;0;1;439;439.00
sprzedawca na stacji paliw;1;1;0;165;165.00
sprzedawca - magazynier;1;0;1;151;151.00
spiker radiowy;1;1;0;504;504.00
społeczny kurator sądowy;1;0;1;692;692.00
specjalista ds. zagospodarowania przestrzennego;1;1;0;3398;3398.00
specjalista monitoringu systemów zabezpieczeń;1;1;0;572;572.00
specjalista monitoringu systemów zabezpieczeń technicznych osób i mienia;1;1;0;2254;2254.00
specjalistka do spraw zarządzania;1;0;1;336;336.00
specjalistka ds. marketingu;1;0;1;360;360.00
specjalistka ds. obsługi klienta;1;0;1;635;635.00
specjalistka polityki społecznej;1;0;1;386;386.00
specjalistka prawa pracy;1;0;1;635;635.00
specjalista ds. organizacji usług gastronomicznych, hotelarskich i turystycznych;1;0;1;1704;1704.00
specjalista ds. marketingu społecznego;1;1;0;2459;2459.00
specjalista ds. obsługi projektów;1;1;0;2204;2204.00
specjalista ds. administracji i rozwoju;1;0;1;215;215.00
specjalista ds. marketingu;1;1;0;568;568.00
specjalista ds. szkoleń i rozwoju;1;0;1;1284;1284.00
specjalista ds. technologii informatycznych;1;1;0;1341;1341.00
specjalista ds. teletransmisji;1;0;1;369;369.00
specjalista ds. turystyki;1;0;1;165;165.00
specjalista ds. rekrutacji;1;0;1;230;230.00
specjalista ds. rozliczeń;1;0;1;353;353.00
specjalista ds. procesu;1;1;0;750;750.00
specjalista ds. zarządzania i organizacji;1;1;0;409;409.00
specjalista ds. zarządzania kryzysowego;1;0;1;874;874.00
specjalista ds. zarządzania zasobami ludzkimi;1;0;1;481;481.00
specjalista ds. zrównoważonego rozwoju;1;0;1;1221;1221.00
specjalista fizjoterapii;1;1;0;420;420.00
specjalista HR;1;0;1;1920;1920.00
specjalista ochrony środowiska (emerytowany);1;1;0;729;729.00
specjalista pielęgniarstwa epidemiologicznego;1;0;1;420;420.00
specjalista pracy socjalnej;1;0;1;1589;1589.00
specjalista resocjalizacji;1;0;1;770;770.00
specjalista sprzedaży internetowej;1;1;0;658;658.00
specjalista sprzedaży technologii i usług informatycznych;1;0;1;774;774.00
specjalista transportu;1;1;0;237;237.00
rzeźnik;1;1;0;24;24.00
sadownik;1;1;0;1440;1440.00
salowa;1;0;1;1212;1212.00
sanitariusz;1;1;0;9;9.00
sanitariusz szpitalny;1;0;1;281;281.00
scenograf;1;1;0;468;468.00
rolnik - ogrodnik;1;0;1;76;76.00
rolnik emerytowany;1;1;0;4125;4125.00
rolnik, samorządowiec;1;0;1;826;826.00
rolnik-emeryt;1;1;0;67;67.00
rysownik satyryczny;1;1;0;130;130.00
rzecznik patentowy;1;1;0;3250;3250.00
rzecznik prasowy;1;1;0;495;495.00
rzecznik praw konsumenta;1;1;0;1154;1154.00
recepcjonista hotelowy;1;0;1;630;630.00
realizator dźwięku;1;1;0;282;282.00
publicystka;1;0;1;2362;2362.00
robotnik gospodarczy;1;0;1;411;411.00
rodzic zastępczy;1;0;1;836;836.00
renowator zabytków architektury;1;1;0;348;348.00
reżyser;1;1;0;209;209.00
redaktor wydawniczy;1;0;1;264;264.00
przedstawiciel władzy samorządowej (burmistrz);1;1;0;11720;11720.00
przedstawiciel władzy samorządowej (radna);1;0;1;1097;1097.00
przedstawiciel ds. promocji;1;1;0;648;648.00
przedstawiciel medyczny;1;1;0;694;694.00
przedstawiciel władz samorządowych;1;1;0;5965;5965.00
przedsiębiorca budowlany;1;1;0;419;419.00
przedsiębiorca kierownik projektów środowiskowych;1;0;1;1191;1191.00
przedsiębiorca prywatny;1;0;1;1625;1625.00
przedsiębiorca rolny;1;1;0;7360;7360.00
przedsiębiorca technik masażysta;1;1;0;720;720.00
przedsiębiorca transport międzynarodowy;1;0;1;144;144.00
przedsiębiorca, rolnik;1;1;0;1806;1806.00
przedsiębiorca-rolnik;1;1;0;608;608.00
przedstawiciel władzy samorządowej (wicestarosta);1;1;0;2793;2793.00
przedstawicielka medyczna;1;0;1;1913;1913.00
przedstawicielka władzy samorządowej;1;0;1;1355;1355.00
przewodnik;1;0;1;868;868.00
przewodnik górski;1;1;0;1942;1942.00
przewodnik turystyczny miejski;1;0;1;1047;1047.00
przedstawiciel władzy samorządowej - radna;1;0;1;1131;1131.00
psychoterapeutka;1;0;1;8568;8568.00
radna;1;0;1;1330;1330.00
radna wojewódzka;1;0;1;2107;2107.00
radny;1;1;0;1032;1032.00
pracownik administracji uczelni;1;1;0;946;946.00
pracownik administracyjny szpitala;1;0;1;256;256.00
pracownik agencji pracy tymczasowej;1;1;0;279;279.00
pracownik agencji rządowej;1;0;1;1328;1328.00
pracownik administracji państwowej;1;1;0;157;157.00
pr manager;1;1;0;908;908.00
pracownica instytucji samorządowej;1;0;1;6814;6814.00
polonistka;1;0;1;674;674.00
pracownik instytucji kultury;1;0;1;1204;1204.00
pracownik jednostki pomocy społecznej;1;0;1;289;289.00
pracownik kancelaryjny;1;1;0;1572;1572.00
pracownik medyczny;1;0;1;119;119.00
pracownik produkcji i kontroli jakości;1;0;1;672;672.00
pracownik do spraw osobowych;1;0;1;670;670.00
pracownik do spraw produktów finansowych;1;0;1;356;356.00
pracownik ds. kadr i płac;1;0;1;734;734.00
pracownik działu kadr;1;0;1;178;178.00
pracownik działu logistyki;1;1;0;229;229.00
pracownik firmy motoryzacyjnej;1;1;0;591;591.00
projektant mody;1;0;1;1174;1174.00
projektant wnętrz;1;0;1;110;110.00
promotor marki trendsetter;1;0;1;498;498.00
protetyk słuchu;1;1;0;308;308.00
programista systemów sztucznej inteligencji;1;1;0;762;762.00
programistka;1;0;1;742;742.00
programistka aplikacji;1;0;1;2060;2060.00
projektant architekt;1;1;0;144;144.00
prawnik - adwokat;1;0;1;5154;5154.00
prawnik legislator;1;1;0;5277;5277.00
prezenter muzyczny;1;1;0;391;391.00
pracownik służby zdrowia;1;0;1;84;84.00
pracownik służby zdrowia, przedsiębiorca;1;0;1;894;894.00
pracownik spółki miejskiej;1;1;0;318;318.00
pracownik umysłowy;1;0;1;141;141.00
pracownik warsztatowy;1;1;0;484;484.00
prezes fundacji;1;0;1;401;401.00
prezes spółdzielni mieszkaniowej;1;0;1;7571;7571.00
prezes spółki;1;0;1;530;530.00
prezes spółki branży budowlanej;1;1;0;1347;1347.00
prezes wydawnictwa;1;1;0;1350;1350.00
prezes zarządu;1;1;0;737;737.00
prezes zarządu spółki;1;1;0;234;234.00
producent teatralny;1;0;1;735;735.00
product manager;1;1;0;1069;1069.00
profesor nauk rolniczych;1;0;1;1205;1205.00
profesor uniwersystetu;1;1;0;527;527.00
operator maszyny sztancującej;1;0;1;219;219.00
operator obrabiarek skrawających;1;1;0;234;234.00
operator produkcji;1;1;0;564;564.00
operator urządzeń do obróbki surowca mleczarskiego;1;0;1;1399;1399.00
operator urządzeń do produkcji makaronu;1;1;0;367;367.00
operator urządzeń oczyszczania ścieków;1;1;0;510;510.00
operator urządzeń sterowanych numerycznie;1;1;0;164;164.00
operator urządzeń uzdatniania i demineralizacji wody;1;1;0;1996;1996.00
opiekun klienta;1;0;1;704;704.00
opiekunka osób starszych;1;0;1;287;287.00
opiekunka środowiskowa;1;0;1;894;894.00
opiekunka w żłobku;1;0;1;327;327.00
optometrysta;1;0;1;183;183.00
organizator imprez masowych;1;1;0;144;144.00
opiekun osób niepełnosprawnych;1;0;1;240;240.00
opiekun osób starszych;1;0;1;170;170.00
opiekun osób z niepełnosprawnością;1;0;1;1020;1020.00
opiekunka domowa;1;0;1;206;206.00
organizator przemysłu;1;0;1;1133;1133.00
paleontolog;1;0;1;160;160.00
pedagog mediator od spraw rodzinnych;1;0;1;6416;6416.00
pedagog pedagogiki specjalnej o specjalności resocjalizacja;1;1;0;512;512.00
pedagog pracy;1;0;1;807;807.00
pedagog szkolny;1;0;1;496;496.00
pedagog-nauczyciel;1;1;0;1542;1542.00
pełnomocnik ds. systemów zarządzania jakością;1;1;0;299;299.00
piekarz;1;0;1;50;50.00
pielęgniarka - specjalista pielęgniarstwa kardiologicznego;1;0;1;505;505.00
pielęgniarka - specjalista pielęgniarstwa opieki długoterminowej;1;0;1;4866;4866.00
pielęgniarka oddziałowa;1;0;1;684;684.00
pielęgniarka z tytułem specjalisty;1;0;1;3797;3797.00
pielęgniarka, nauczyciel akademicki;1;0;1;1047;1047.00
pozostali filolodzy i tłumacze;1;1;0;1079;1079.00
pozostali kierownicy do spraw produkcji przemysłowej;1;1;0;648;648.00
"pozostali kierownicy; dyrektorzy w instytucjach opieki nad dziećmi";1;0;1;3015;3015.00
pozostali pracownicy ds. rachunkowości i księgowości;1;0;1;947;947.00
pozostali pracownicy działów kadr;1;0;1;421;421.00
pozostali specjaliści do spraw księgowości i rachunkowości;1;0;1;3219;3219.00
pozostali specjaliści do spraw ochrony środowiska;1;0;1;554;554.00
pozostali specjaliści nauczania i wychowania gdzie indziej sklasyfikowani;1;0;1;188;188.00
pozostali specjaliści ochrony zdrowia gdzie indziej nie sklasyfikowani;1;0;1;746;746.00
politolog, kierownik projektu;1;1;0;153;153.00
politolożka;1;0;1;1523;1523.00
poseł RP;1;1;0;7715;7715.00
pośrednictwo pieniężne;1;1;0;220;220.00
pośrednik nieruchomości;1;1;0;256;256.00
pośrednik usług medycznych;1;1;0;790;790.00
policjant emeryt;1;1;0;790;790.00
policjant służby prewencji;1;1;0;1064;1064.00
policjant służby prewencyjnej;1;0;1;1683;1683.00
policjantka;1;0;1;8381;8381.00
poligraf;1;1;0;189;189.00
pilot wycieczek turystycznych;1;0;1;324;324.00
piosenkarka;1;0;1;1359;1359.00
pisarka;1;0;1;615;615.00
położna dyplomowana;1;0;1;507;507.00
pomoc dentystyczna;1;0;1;123;123.00
pomoc nauczyciela;1;0;1;237;237.00
portier;1;1;0;539;539.00
portier-pracownik gospodarczy;1;1;0;257;257.00
poseł;1;0;1;14616;14616.00
poseł na Sejm;1;1;0;10962;10962.00
nauczyciel religii;1;1;0;389;389.00
nauczyciel specjalista terapii pedagogicznej;1;0;1;3141;3141.00
nauczyciel szkoły podstawowej;1;1;0;474;474.00
nauczyciel szkoły ponadpodstawowej;1;1;0;328;328.00
nauczyciel szkół podstawowych;1;1;0;192;192.00
nauczyciel sztuki w placówkach pozaszkolnych;1;0;1;1744;1744.00
nauczyciel urzędnik państwowy;1;0;1;5463;5463.00
nauczyciel w placówkach pozaszkolnych;1;0;1;678;678.00
nauczyciel wychowania przedszkolnego;1;0;1;456;456.00
nauczyciel wykładowca;1;1;0;1153;1153.00
nauczyciel zawodu;1;0;1;313;313.00
nauczyciel, kierownik urzędu stanu cywilnego;1;0;1;663;663.00
nauczyciel-emeryt;1;0;1;731;731.00
nauczyciel przedmiotów zawodowych artystycznych;1;0;1;2515;2515.00
nauczycielka akademicka - sztuka;1;0;1;1786;1786.00
nauczycielka matematyki;1;0;1;1260;1260.00
nauczycielka przedmiotów ekonomicznych;1;0;1;3759;3759.00
nauczycielka-pedagog;1;0;1;768;768.00
naukowiec;1;1;0;3574;3574.00
oficer pożarnictwa;1;1;0;750;750.00
oficer rezerwy;1;1;0;81;81.00
nauczycielka akademicka;1;0;1;9791;9791.00
operator maszyn i urządzeń;1;1;0;3791;3791.00
operator maszyn i urządzeń do przeróbki mechanicznej rud;1;1;0;118;118.00
operator maszyn i urządzeń metalurgicznych;1;1;0;328;328.00
operator maszyn przemysłowych;1;1;0;332;332.00
oficer służby kryminalnej;1;0;1;381;381.00
oficer zawodowy sił zbrojnych;1;0;1;1774;1774.00
operator;1;1;0;82;82.00
operator cnc;1;0;1;649;649.00
nauczyciel logopeda;1;0;1;121;121.00
nauczyciel mgr historii;1;1;0;1774;1774.00
nauczyciel muzyki;1;1;0;403;403.00
nauczyciel muzykolog;1;0;1;2233;2233.00
nauczyciel nauczania początkowego;1;0;1;1300;1300.00
nauczyciel niedostosowanych społecznie;1;0;1;2319;2319.00
nauczyciel niesłyszących i słabosłyszących (surdopedagog);1;0;1;6461;6461.00
nauczyciel osób z niepełnosprawnością intelektualną (oligofrenopedagog);1;1;0;339;339.00
nauczyciel pedagog;1;0;1;580;580.00
nauczyciel plastyki;1;0;1;958;958.00
nauczyciel praktycznej nauki zawodu;1;0;1;771;771.00
nauczyciel geografii;1;1;0;399;399.00
nauczyciel germanista;1;0;1;640;640.00
nauczyciel języka angielskiego;1;0;1;591;591.00
nauczyciel konsultant;1;0;1;1760;1760.00
nauczyciel przedmiotów w szkole ponadpodstawowej;1;0;1;587;587.00
nauczyciel chemii;1;0;1;1880;1880.00
nauczyciel domowy;1;0;1;468;468.00
nauczyciel akademicki nauk rolniczych;1;0;1;335;335.00
nauczyciel akademicki nauki społeczne;1;1;0;230;230.00
nauczyciel emeryt;1;0;1;321;321.00
nauczyciel emerytowany;1;0;1;432;432.00
nauczyciel filolog;1;0;1;184;184.00
nauczyciel fizyki;1;1;0;2096;2096.00
mgr inż. mechanik okrętowy;1;1;0;5356;5356.00
nauczyciel - pedagog specjalny;1;0;1;239;239.00
nauczyciel akademicki - nauki medyczne i nauki o zdrowiu;1;1;0;4182;4182.00
nauczyciel akademicki - kierunki ekonomiczne;1;1;0;3422;3422.00
właściciel sklepów;1;1;0;1817;1817.00
wykładowczyni akademicka;1;0;1;686;686.00
wyższy urzędnik administracji państwowej;1;1;0;378;378.00
wyższy urzędnik samorządowy - burmistrz;1;1;0;2763;2763.00
wyższy urzędnik władz samorządowych;1;1;0;2587;2587.00
zaopatrzeniowiec;1;0;1;605;605.00
zawodnik sportu żużlowego;1;1;0;598;598.00
zdobnik-ceramik;1;0;1;3640;3640.00
zielarz - fitoterapeuta;1;1;0;876;876.00
żołnierz;1;1;0;566;566.00
żołnierz zawodowy;1;1;0;913;913.00
